NO  ./textures/walls.xpm
SO  ./textures/walls.xpm
WE  ./textures/walls.xpm
EA  ./textures/walls.xpm

F  129,95,50
C  72,120,170

111111111111111111111111111111111111111111
111111111111111111111111111111111111111111
111100000000000000000000000000000000000011
111100000000000000000000000000000000000011
111100000111111111000000000000000000000011
111100000100000001000000000000000000000011
111100000100000001000000111111111110000011
111100000100000001000000100000000010000011
111100000100000001111111100000000010000011
1111000001000000000000000H000000010000011
1111000001111111111111111H111000010000011
1111000000000000000000000H000000010000011
111100000000000000000000000000000000000011
111111111100000011111100000000111111111111
111100000100000010000100000000000000000011
111100000111000010000111111111111000000011
111100000001000010000000000000001000000011
111100000001000011111111111100001000000011
111100000001000000000000000100001000000011
111100000001000000000000000111111000000011
111100000001000000000000000000000000000011
111100000001000011111111111111111100000011
111100000001000010000000000000001000000011
111100000001000010000000000000001000000011
111100000111000011111111100000001111111111
111100000000000000000000010000000000000011
1111000000000000000000000H000000000000011
1111000000000000000000000H000000000000011
111100000000000000000000010000000000000011
111100000000000000000000010000000000000011
111100000000000000000000011111111000000011
11110000000000000000W000000000001000000011
111111111111111111111111111111111111111111
