NO ./dummy.cub
SO ./dummy.cub
WE ./dummy.cub
EA ./dummy.cub

F  220,100,0
C  2,30,0

1111111111111111111111111
1000000000000000000000001
1000000000000000000000001
1000000000010000000000001
1000000000000000000000001
1000001000000000000000001
1000000000000000000000001
1000000000001000000000001
1000000000000000000000001
1000010000000000000000001
100000000000N000000000001
1000010000000000000000001
1000000000000000000000001
1111111111111111111111111
