NO  ./textures/colorstone.xpm
SO  ./textures/bluestone.xpm
WE  ./textures/eagle.xpm
EA  ./textures/redbrick.xpm

F  129,95,50
C  72,120,170

1111111111111111111111111111
1111111111111111111111111111
1111000000000000000000000001
1111000000000000000101000001
1111000000000010000101000001
11110000000000000001H1000001
1111000001000000000101000001
11110000000000000001H1000001
11110000000000011111H1111111
1111000000000000000000000001
1111000010000000000000000001
111100000000000W000000000001
1111000010000000000000000001
1111000000000000000000000001
1111111111111111111111111111
