NO  ./textures/walls.xpm
SO  ./textures/walls.xpm
WE  ./textures/walls.xpm
EA  ./textures/walls.xpm

F  129,95,50
C  72,120,170

1111111111111111111111111111
1111111111111111111111111111
1111000000000000000000000001
1111000000000000000101000001
1111000000000010000101000001
11110000000000000001H1000001
1111000001000000000101000001
11110000000000000001H1000001
11110000000000011111H1111111
1111000000000000000000000001
1111000010000000000000100001
11110000H000000W000000H00001
1111000010000000000000100001
1111000000000000000000000001
1111111111111111111111111111
