WE textures/wall1.xpm
NO textures/wall2.xpm
SO textures/wall3.xpm
EA textures/wall4.xpm

F 17,38,64
C 218,234,235

111111111111111111111111
100000000000000000000001
100000000000000000000001
100000000N00000000000001
100000000000000000000001
100000000000000000000001
100000000000000000000001
100000111H10000101010001
100000100010000000000001
100000100010000100010001
100000100010000000000001
10000011100001010100001
100000000000000000000001
100000000000000000000001
100000000000000000000001
100000000000000000000001
100000000000000000000001
100000000000000000000001
100000000000000000000001
111111111000000000000001
100100001000000000000001
100000101000000000000001
100100001000000000000001
100111111000000000000001
100000000000000000000001
100000000000000000000001
111111111111111111111111
